NO ./texture/NO.xpm
SO ./texture/SO.xpm
WE ./texture/WE.xpm
EA ./texture/EA.xpm





F 182,182,182
C 182,182,182



111     1111111111111111111111111
1 1     1000000000110000000000001
111     1011000001110000001000001
        100100000000000000000001
11111111101100000111000000000001
1000000000110000011 10111111111111
11110111111111011101000000001
11110111111111011101010100001
10100000011010101110000000001
10000000000000001100000N001001
100000000000000011010100100011
1100000111010101111101111000111
10000001 1000001 11111100011111
11110111 1110101 10111101011001
11111111 1111111 1111111111111











