
NO ./texture/NO.xpm
SO ./texture/SO.xpm
WE ./texture/WE.xpm
EA ./texture/EA.xpm

C 135,245,251
F 117,142,79




1111111111     111
1000000001     101
1111000001     111
1000000001
100N001001
1010000011
100000000111111111
111111100000000001
      100000111001
      100000001001
      100011111001
      100001100001
      100001000001
      111111111111
