
NO ./texture/NO.xpm
SO ./texture/SO.xpm
WE ./texture/WE.xpm
EA      ./texture/EA.xpm

C 172,21,237
F 		204,237	,57


1111111111
1000000001
1000000001
1000010001
1000000001
1000000001
10000N0001
1111111111