NO ./texture/NO.xpm
SO ./texture/SO.xpm
WE ./texture/WE.xpm
EA ./texture/EA.xpm


F 182,182,182
C 182,182,182

1111111111111111111111111111111111111111
1000000000000000000000000000000000000001
1000000000000000000000000000000000000001
1001111111111111111111111111111111111001
1001000000000000000000000000000000001001
1001011111111111111111111111111111001001
1001011111111111111111111111111111001001
1001011000000000000000000000000001001001
1001011011111111111111111111111101001001
1001011011111111111111111111111101001001
1001011011000000000000000000001101001001
1001011011011111111111111111101101001001
1001011011010000000000000000101101001001
1001011011010000000000000000101101001001
1001011011010011111111111100101101001001
1001011011010010000000000100101101001001
1001011011010010011111100100101101001001
1001011011010010011111100100101101001001
1001011011010010010000100100101101001001
1001011011010010010000100100101101001001
1001011011010010010110100100101101001001
1001011011010010010110100100101101001001
1001011011011110010110111100101101001001
1001011011000000010110000000101101001001
1001011011000000010110000000101101001001
1001011011111111110111111111101101001001
1001011000000000000000000000001101001001
1001011111111111110111111111111101001001
1001011111111111110111111111111101001001
1001000000000000010110000000000001001001
1001111111111110010110111111111111001001
1000000000000010010110110000000000001001
1000000000000010010110110000000000001001
1111111111111110010110111111111101111001
1000000000000000010110000000000000000001
1000000000000000N10110000000000000000001
1111111111111111111111111111111111111111